11111111B1111111
1111111101111111
1111111100000111
1111111111110111
1110000000000111
1110111111111111
1110111111111111
1110000000000111
1111111111110111
1111111110000111
1111111110111111
1100000110000011
1101110111111011
1101110000111011
1101111110000011
11S1111111111111