//LAYOUT// 
//Top Left is (0,0)// '+' for path ' ' for tile
0----------------0
|        +       |0
|        +       |1
|        +       |2
|        +       |3
|   ++++++       |4
|   +    +       |5
|   +    +       |6
|   ++++++       |7
|        +       |8
|        +       |9
|        ++++    |A
|        +  +    |B
|        +  +    |C
|  ++++++++++++++|D
|  +             |E
|  +             |F
0----------------0
 0123456789ABCDEF
//BREAKABLES//
(08|05)
(08|06)
(08|11)
(08|12)
//END//