0111111111111110
1011111111111101
1101111111111011
1110111111110111
1111011111101111
1111101111011111
1111110110111111
1111111001111111
1111111001111111
1111110110111111
1111101111011111
1111011111101111
1110111111110111
1101111111111011
1011111111111101
0111111111111110