11111111B1111111
1111111101111111
1111111100000111
11111111X1110111
1110000000000111
111011X111111111
111011X111111111
1110000000000111
1111111111110111
1111111110000111
1111111110111111
1100000110000011
110111011X111011
110XXX0000111011
1101111110000011
11S1111111111111